################################################################################################################################
#     #                                         #             #                       v                                        #
#  p                                            #             #             #                       #                          #
#                                               #             #               #                                                #
#                                               #             #                                                      #         #
#                                                                                                       #                      #
#             #                                 #                                                            #                 #
# ##### #######                                 #              ###########                                                     #
#             ################################# ##########                           #                                         #
#             #                                 #                             #                                                #
#             # ####                            #           #                                                                  #
#             #                                 #                                                                        #     #
#             #                                 #                                                  #                           #
# #####   #####                                                     #   ##         #                                           #
#       #     #                                #                                                                               #
#             #                                               #                                          #                     #
#             ########################################################## #                                       #             #
#                                                          #                                                                   #
#             #                                            #                                                                   #
#             #       #             #                      #                 #                                                 #
#             #                                            #                                     #             #               #
#       #     #                                            #                                                                   #
##                                                #                                                                            #
#      #      #                                          #        #                            #                               #
#             #                 #                                #        #                                                    #
#             #                                                                                                                #
#             #                                                                                                                #
# #############                                                                                                #               #
#                  #                     #                                        #                                            #
#                                                                                               #                              #
#                                                         #        #                #                                     #    #                                                                                                                   
################################################################################################################################