##############################################################
#p                                               |           #
#                                               |            #
#                                              |             #
#                                             |              #
#                                            |               #
#                                           |                #
#                                          |                 #
#                                         |                  #
#                                        |                   #
#                                       |                    #
#                                      |                     #
#                                     |                      #
#                                    |                       #
#                                   |                        #
#                                  |                         #
#                                 |                          #
#                                |                           #
#                               |                            #
#                              |                             #
#                             |                              #
#                            |                               #
#                           |                                #
#                          |                                 #
#                         |                                  #
#                        |                                   #
#                       |                                    #
#                      |                                     #
#                     |                                      #
#                    |                                       #
#                   |                                        #
#                  |                                         #
#                 |                                          #
#                |                                           #
#               |                                            #
#              |                                             #
#             |                                              #
#            |                                               #
#           |                                                #
#          |                                                 #
#         |                                                  #
#        |                                                   #
#       |                                                    #
#      |                                                     #
#     |                                                      #
#    |                                                       #
#   |                                                        #
#  |                                                         #
# |                                                          #
##############################################################
