################################################################################################################################
#     #                                         #             #                       ^                                        #
#                                               #             #             #         |             #                          #
#                                               #             #               #       |                                        #
#                                               #             #                       |                              #         #
#                                                                                     |                 #                      #
#             #                                 #                                     |                      #                 #
# ##### #######                                 #              ###########            |                                        #
#             ################################# ##########                           #|                                        #
#             #                                 #                             #       |                                        #
#             # ####                            #           #                         |                                        #
#             #                                 #                                     |                                  #     #
#             #                                 #                                     v            #                           #
# #####   #####                                                     #   ##         #                                           #
#       #     #                                #                                                                               #
#             #                                               #                                          #                     #
#             ########################################################## #                                       #             #
#                                                          #                                                                   #
#             #                                            #                                                                   #
#             #       #             #                      #                 #                                                 #
#             #                                            #                                     #             #               #
#       #     #                                            #                                                                   #
##                                                #                                                                            #
#      #      #                                          #        #                            #                               #
#             #                 #                                #        #                                                    #
#             #                                                                                                                #
#             #                                                                                                                #
# #############                                                                                                #               #
#                  #                     #                                        #                                            #
#                                                                                               #                              #
#                                                         #        #                #                                     #    #                                                                                                                   
################################################################################################################################