################################################################################################################################
#     #                                         #             ##                                                               #
#  p                                            #                                                   #                          #
#                                               #                             #                                                #
#                                               #                                                                    #         #
#                                                                                                       #                      #
#             #                                 #                                                            #                 #
# ##### #######                                 #              ###########                                                     #
#             ################################# ##########                                                                     #
#             #                                 #                             #                                                #
#             # ####                            #           #                                                                  #
#             #                                 #                                                                        #     #
#             #                                 #                                                  #                           #
# #####   #####                                                     #   ##         #                                           #
#       #     #                                #                                                                               #
#             #                                                                       #                  #                     #
#             ########################################################## #                                       #             #
#                                                          #                                                                   #
#             #                                            #                                                                   #
#             #       #             #                      #                 #                                                 #
#             #                                            #                                     #             #               #
#       #     #                                            #                                                                   #
##                                                #                                                                            #
#      #      #             @                            #        #                            #                               #
#             #                 #                                #        #                                                    #
#             #                                                                                                                #
#             #                                                                       X                                        #
# #############                                                                       X                        #               #
#                  #                     #                                        #   X                                        #
#                                                                                     X         #                              #
#                           @                             <#        #                #                                     #   #                                                                                                                   
################################################################################################################################