#############################################################
#pvvvvvvvvvvvvvvvvvvvvvvvvvvvvvvvvvvvvvvvvvvvvvvvvvvvvvvvvvv#
# XXXXXXXXXXXXXXXXXXXXXXXXXXXXXXXXXXXXXXXXXXXXXXXXXXXXXXXXXX#
# XXXXXXXXXXXXXXXXXXXXXXXXXXXXXXXXXXXXXXXXXXXXXXXXXXXXXXXXXX#
#                                                       XXXX#
#XXXXXXXXXXXXXXXXXXXXXXXXXXXXXXXXXXXXXXXXXXXXXXXXXXXXXX XXXX#
# XXXXXXXXXXXXXXXXXXXXXXXXXXXXXXXXXXXXXXXXXXXXXXXXXXXXX XXXX#
# XXXXXXXXXXXXXXXXXXXXXXXXXXXXXXXXXXXXXXXXXXXXXXXXXXXXX XXXX#
# XXXXXXX                                       XXXXXXX XXXX#
# XXXXXXX XXXXXXXXXXXXXXXXXXXXXXXXXXXXXXXXXXXXX XXXXXXX XXXX#
# XXXXXXX XXXXXXXXXXXXXXXXXXXXXXXXXXXXXXXXXXXXX XXXXXXX XXXX#
# XXXXXXX XXXXXXXXXXXXXXXXXXXXXXXXXXXXXXXXXXXXX XXXXXXX XXXX#
# XXXXXXX XXXXX                         XXXXXXX XXXXXXX XXXX#
# XXXXXXX XXXXX XXXXXXXXXXXXXXXXXXXXXXX XXXXXXX XXXXXXX XXXX#
# XXXXXXX XXXXX XXXXXXXXXXXXXXXXXXXXXXX XXXXXXX XXXXXXX XXXX#
# XXXXXXX XXXXX XXXXXXXXXXXXXXXXXXXXXXX XXXXXXX XXXXXXX XXXX<
# XXXXXXX XXXXX XXXXXXXXXXXXXXXXXXXXXXX XXXXXXX XXXXXXX XXXX<
# XXXXXXX XXXXX XXXXX             XXXXX XXXXXXX XXXXXXX XXXX<
# XXXXXXX XXXXX XXXXX ###@@@@@@## XXXXX XXXXXXX XXXXXXX XXXX<
# XXXXXXX XXXXX XXXXX #         # XXXXX XXXXXXX XXXXXXX XXXX<
# XXXXXXX XXXXX XXXXX @         @ XXXXX XXXXXXX XXXXXXX XXXX<
# XXXXXXX XXXXX XXXXX @         @ XXXXX XXXXXXX XXXXXXX XXXX<
# XXXXXXX XXXXX XXXXX @         @ XXXXX XXXXXXX XXXXXXX XXXX<
#>XXXXXXX XXXXX XXXXX @         @ XXXXX XXXXXXX XXXXXXX XXXX<
#>XXXXXXX XXXXX XXXXX @         @ XXXXX XXXXXXX XXXXXXX XXXX<
#>XXXXXXX XXXXX XXXXX @         @ XXXXX XXXXXXX XXXXXXX XXXX<
#>XXXXXXX XXXXX XXXXX @         @ XXXXX XXXXXXX XXXXXXX XXXX#
#>XXXXXXX XXXXX XXXXX @         @ XXXXX XXXXXXX XXXXXXX XXXX#
#>XXXXXXX XXXXX XXXXX ##      @ @ XXXXX XXXXXXX XXXXXXX XXXX#
#>XXXXXXX XXXXX XXXXX ## @@@@@@## XXXXX XXXXXXX XXXXXXX XXXX#
#>XXXXXXX XXXXX XXXXX XX          XXXXX XXXXXXX XXXXXXX XXXX#
#>XXXXXXX XXXXX XXXXX XXXXXXXXXXXXXXXXX XXXXXXX XXXXXXX XXXX#
#>XXXXXXX XXXXX XXXXX XXXXXXXXXXXXXXXXX XXXXXXX XXXXXXX XXXX#
#>XXXXXXX XXXXX XXXXX XXXXXXXXXXXXXXXXX XXXXXXX XXXXXXX XXXX#
#>XXXXXXX XXXXX XXXXX                   XXXXXXX XXXXXXX XXXX#
#>XXXXXXX XXXXX XXXXXXXXXXXXXXXXXXXXXXXXXXXXXXX XXXXXXX XXXX#
#>XXXXXXX XXXXX XXXXXXXXXXXXXXXXXXXXXXXXXXXXXXX XXXXXXX XXXX#
#>XXXXXXX XXXXX XXXXXXXXXXXXXXXXXXXXXXXXXXXXXXX XXXXXXX XXXX#
#>XXXXXXX XXXXX XXXXXXXXXXXXXXXXXXXXXXXXXXXXXXX XXXXXXX XXXX#
# XXXXXXX XXXXX                                 XXXXXXX XXXX#
# XXXXXXX XXXXXXXXXXXXXXXXXXXXXXXXXXXXXXXXXXXXXXXXXXXXX XXXX#
# XXXXXXX XXXXXXXXXXXXXXXXXXXXXXXXXXXXXXXXXXXXXXXXXXXXX XXXX#
# XXXXXXX XXXXXXXXXXXXXXXXXXXXXXXXXXXXXXXXXXXXXXXXXXXXX XXXX#
# XXXXXXX                                               XXXX#
# XXXXXXXXXXXXXXXXXXXXXXXXXXXXXXXXXXXXXXXXXXXXXXXXXXXXXXXXXX#
# XXXXXXXXXXXXXXXXXXXXXXXXXXXXXXXXXXXXXXXXXXXXXXXXXXXXXXXXXX#
# XXXXXXXXXXXXXXXXXXXXXXXXXXXXXXXXXXXXXXXXXXXXXXXXXXXXXXXXXX#
# XXXXXXXXXXXXXXXXXXXXXXXXXXXXXXXXXXXXXXXXXXXXXXXXXXXXXXXXXX#
# ^^^^^^^^^^^^^^^^^^^^^^^^^^^^^^^^^^^^^^^^^^^^^^^^^^^^^^^^^^#
#############################################################
