#############################################################
#                              ^                            #
#                              #                            #
#                              #                            #
#                              #                            #
#                              #                            #
#                              #                            #
#                              #                            #
#                              #                            #
#                              #                            #
#                              #                            #
#                              #                            #
#                              #                            #
#                              #                            #
#                              #                            #
#                              #                            #
#                              #                            #
#                              #                            #
#                              #                            #
#                              #                            #
#                              #                            #
#                              v                            #
#                                                           #
#                                                           #
#                                                           #
#                                                           #
#                                                           #
#                                                           #
#                                                           #
#                                                           #
#                                                           #
#                                                           #
#                                                           #
#                                                           #
#                                                           #
#                                                           #
#                                                           #
#                                                           #
#                                                           #
#                                                           #
#                                                           #
#                                                           #
#                                                           #
#                                                           #
#                                                           #                                                           #
#                                                           #
#                                                           #
#                                                           #
#                                                           #
#############################################################
